Elaborate|Подробный|False
Ambiguous|Двусмысленный|False
Enhance|Усиливать|False
Resilient|Устойчивый|False
Diverse|Разнообразный|False
Comprehend|Понимать|False
Elusive|Непостижимый|False
Collaborate|Сотрудничать|False
Integrate|Интегрировать|False
Intricate|Сложный|False
Illuminate|Освещать|False
Persuasive|Убедительный|False
Credible|Заслуживающий доверия|False
Substantial|Существенный|False
Inevitable|Неизбежный|False
Consistent|Последовательный|False
Precise|Точный|False
Esteem|Уважение|False
Exquisite|Изысканный|False
Intriguing|Захватывающий|False
Proficient|Опытный|False
Exemplary|Примерный|False
Ample|Обильный|False
Modest|Скромный|False
Auspicious|Благоприятный|False
Ubiquitous|Вездесущий|False
Pristine|Безупречный|False
Sustained|Постоянный|False
Enduring|Долговечный|False
Hesitant|Нерешительный|False
