Cat|Кошка|False
Dog|Собака|False
Book|Книга|False
Table|Стол|False
Chair|Стул|False
Sun|Солнце|False
Moon|Луна|False
Tree|Дерево|False
House|Дом|False
Car|Машина|False
Ball|Мяч|False
Lake|Озеро|False
River|Река|False
Flower|Цветок|False
Bird|Птица|True
Fish|Рыба|False
Clock|Часы|False
Hat|Шляпа|False
Shirt|Рубашка|False
Pants|Штаны|False
Shoes|Обувь|False
Bed|Кровать|False
Chair|Кресло|False
Door|Дверь|False
Window|Окно|False
Pen|Ручка|False
Pencil|Карандаш|False
Phone|Телефон|False
Tablecloth|Скатерть|False
Plate|Тарелка|False
Apple|Яблоко|False
Banana|Банан|False
Orange|Апельсин|False
Grape|Виноград|False
Pear|Груша|False
Strawberry|Клубника|False
Tomato|Помидор|False
Carrot|Морковь|False
Potato|Картофель|False
Corn|Кукуруза|False
Bread|Хлеб|False
Milk|Молоко|False
Cheese|Сыр|False
Egg|Яйцо|False
Meat|Мясо|False
Chicken|Курица|False
Fish|Рыба|False
Rice|Рис|False
Pasta|Макароны|False
Soup|Суп|False