Conscientiousness|Добросовестность|False
Sophisticated|Сложный, утонченный|False
Entrepreneurship|Предпринимательство|False
Exacerbate|Обострять|False
Incredulous|Недоверчивый|False
Discombobulate|Сбивать с толку|False
Intransigent|Непреклонный|False
Perseverance|Упорство|False
Intransigent|Неотменяемый|False
Serendipity|Счастливое стечение обстоятельств|False
Pseudonym|Псевдоним|False
Magnanimous|Великодушный|False
Querulous|Жалобный|False
Procrastination|Прокрастинация|False
Rambunctious|Буйный|False
Inconsequential|Неосновательный|False
Indubitable|Бесспорный|False
Ineffable|Неописуемый|False
Mellifluous|Мелодичный|False
Esoteric|Эзотерический|False
Ambivalent|Двоякий|False
Ponderous|Громоздкий|False
Verisimilitude|Вероятность, правдоподобие|False
Inextricable|Неразрывный|False
Recalcitrant|Упрямый|False
Equanimity|Равновесие, спокойствие|False
Unpretentious|Беспритязательный|False
Imperturbable|Непоколебимый|False
Ineffable|Несказанный|False
Obstreperous|Сопротивляющийся|False