Подробный|Elaborate|False
Двусмысленный|Ambiguous|False
Усиливать|Enhance|False
Устойчивый|Resilient|False
Разнообразный|Diverse|False
Понимать|Comprehend|False
Непостижимый|Elusive|False
Сотрудничать|Collaborate|False
Интегрировать|Integrate|False
Сложный|Intricate|False
Освещать|Illuminate|False
Убедительный|Persuasive|False
Заслуживающий доверия|Credible|False
Существенный|Substantial|False
Неизбежный|Inevitable|False
Последовательный|Consistent|False
Точный|Precise|False
Уважение|Esteem|False
Изысканный|Exquisite|False
Захватывающий|Intriguing|False
Опытный|Proficient|False
Примерный|Exemplary|False
Обильный|Ample|False
Скромный|Modest|False
Благоприятный|Auspicious|False
Вездесущий|Ubiquitous|False
Безупречный|Pristine|False
Постоянный|Sustained|False
Долговечный|Enduring|False
Нерешительный|Hesitant|False