Добросовестность|Conscientiousness|False
Сложный, утонченный|Sophisticated|False
Предпринимательство|Entrepreneurship|False
Обострять|Exacerbate|False
Недоверчивый|Incredulous|False
Сбивать с толку|Discombobulate|False
Непреклонный|Intransigent|False
Упорство|Perseverance|False
Неотменяемый|Irrevocable|False
Счастливое стечение обстоятельств|Serendipity|False
Псевдоним|Pseudonym|False
Великодушный|Magnanimous|False
Жалобный|Querulous|False
Прокрастинация|Procrastination|False
Буйный|Rambunctious|False
Неосновательный|Inconsequential|False
Бесспорный|Indubitable|False
Неописуемый|Ineffable|False
Мелодичный|Mellifluous|False
Эзотерический|Esoteric|False
Двоякий|Ambivalent|False
Громоздкий|Ponderous|False
Вероятность, правдоподобие|Verisimilitude|False
Неразрывный|Inextricable|False
Упрямый|Recalcitrant|False
Равновесие, спокойствие|Equanimity|False
Беспритязательный|Unpretentious|False
Непоколебимый|Imperturbable|False
Несказанный|Ineffable|False
Сопротивляющийся|Obstreperous|False